B---B---B---B---B---B
|   |   |   |   |   |
B---B---B---B---B---B
|   |   |   |   |   |
B---B---B---B---B---B
|   |   |   |   |   |
B---B---B---B---B---B
|   |   |   |   |   |
B---B---B---B---B---B

B->-B---B   B->-B---B
|   v   |   ^   |   |
B-<-B   B-<-B-<-B-<-B
|   |       ^       |
B->-B-<-B->-B   B---B
|   |   ^   |   |   |
B---B   B-<-B   B-<-B
|   |   v       ^   |
B---B-<-B->-B---B-<-B
